Ahoj!	Naaj!	(z Im narim a aj, tj. vidím tě)
Dobrý den.	Nert dis.
Na shledanou.	Kanima. / Kan ima utnarima a ima.

ano	pa
ne	nos

a	en

já	im
ty	aj
on	ok
my	ima
vy	aja
oni	oka

žena	ar
muž	to

(přímý objekt)	a
(objekt čísl.)	ob
(mod. přání)	kan
(mod. dotaz)	jet

(min. čas)	one
(bud. čas)	ale
(dokonavost)	-on
(nedokonavost)	-al

co	jedo
kdo	jera

něco	jando

do	do
k	up
pro	fi
v	me
z	ri
na téma	ta
